222222222222-
200111111002-
202211111102-
212111111212-
201111112202-
200111111002-
222222222222